1111111
1200131
1011101
1101001
1011101
1000131
1111111
