11111111111111
10000000000001
10100020100011
10101003000011
10000100010011
10000001000101
10000000000001
10010100000001
10000033010001
10101033001001
10100010000001
10000100010001
10000000000001
11111111111111
