111111111111
101110011001
100001100001
101000000001
100110101001
110012110101
101010000011
100001110011
101000001001
100100110001
100310000001
111111111111
