1111111111111111111111
1000001000000010000001
1011101111101010111101
1002100000000010000001
1111101111101010111111
1000001000000010000001
1110111111111010111111
1000100000000000000001
1011110111110101110101
1000100001000010000001
1011111101010111011111
1000000010000010000001
1011111101111101110111
1000100000000010000001
1010111110111110101111
1000100000000010000001
1111101010111110101111
1000001010000013100001
1011101011111110111101
1000100010000010000001
1000100010000010000001
1111111111111111111111
