11111
10031
10211
11011
11111