11111111111111111
10000000000000021
10000000000000001
10000000000000001
10000110001100001
10001331013310001
10013333133331001
10133331313333101
11333313131333311
10133313331333101
10013331313331001
10001333133310001
10000131313100001
10000011311000001
10000001310000001
10000000100000001
11111111111111111
