111111111111
100000000001
100010010001
100010010001
101111111101
100013310201
100013310001
101111111101
100010010001
100010010001
100000000001
111111111111
