11111111111111111
10000000000000121
10000000000000131
10000000000000131
10000110001100131
10001331013310131
10013333133331111
10133331313333131
11333313131333111
10133313331333131
10013331313331111
10001333133310131
10000131313100131
10000011311000131
10000001310000111
10000000100000131
11111111111111111
