111111111111
100000000001
101211111001
101000001001
101011101111
100010000001
111011110101
100000010101
101110010101
101000010101
131111110101
111111111111