11111
10201
11101
10031
11111