111111111111
100000000001
101011131001
101000001001
101011101111
100010000001
111011110101
100000010101
101110010101
101000210101
101111110101
111111111111